444441444144441111111-
111141414141141111111-
111141414141141111111-
111141414141141111111-
111141414141141111111-
111141414141141111111-
111144414441144111111-
111111111111111111111