44441444144441111111-
11141414141141111111-
11141414141141111111-
11141414141141111111-
11141414141141111111-
11141414141141111111-
11144414441144111111-
11111111111111111111